

NO Agvan

WE SSSSS


F 222.222.222

SO POS
EA EaAAAA

C 255.255.255





1111
10001

100001
111111


