NO	./textures/bluestone.xpm
				WE	./textures/eagle.xpm



EA	./textures/redbrick.xpm

C	65,65,255
F	255,19,00001

SO	./textures/greystone.xpm


11
1
11111111111111111111111111111111111
100000000010000000000000000000000001
100000000010000000000000000000000001  1
1000000111000000000000000000000000001
1000E00DDD00000000000000000000000001    
10000001110000000000000000000000001
111111111111111111111111111111111111
   11111
111111111111111111111111111111111111
100000000000000000000000000000000001
100000000000000000000000000000000001
111111111111111111111111111111111111
11111111111							111
10000000011							101
11111111111							111
