NO ./textures/main/wall_4.xpm
WE ./textures/main/wall_3.xpm
SO ./textures/main/wall_2.xpm
EA ./textures/main/wall_1.xpm
DO ./textures/main/dooropen.xpm
DC ./textures/main/doorclose.xpm

C 5,6,7
F 30,31,32

1111111111
1001
1111111111111111 1111111111111111111
100000000010000000000000001110000001
100000000010000000000000000D10000001	1
1000000111000000000000000011100000001
1000100D0D00000E00001000000000000001
10000001110000000001 1000000000000001
100000000000000000001000000000000001
100000000000000000000000000000000001
111111111111111111111111111111111111
11111111111							1
10000000011							1
11111111111
							1
