NO	./textures/bluestone.xpm
				WE	./textures/eagle.xpm



EA	./textures/redbrick.xpm

C	65,65,255
F	255,19,00001

SO	./textures/greystone.xpm

111111111111111111111111111111111111
111111111111011111111111111111111111
111111111111011111111111111111111111
111111111111111111111111111111111111

111111111111111111111111111111111111
111111111111111111111111111111111111
111111111111111111111111111111111111
111111111111111111111111111111111111
111111111111111111111111111111111111
111111111111	11111111111111111111
111111111111111111111111111111111111
111111111111111111111111111111111111
111111111111111111111111111111111111