NO ./textures/bluestone.xpm
WE ./textures/eagle.xpm
SO ./textures/greystone.xpm
EA ./textures/redbrick.xpm

C 135,206,235
F 62,97,16

1111111111
1001
11111111111111111111111111111111111
100000000010000000000000001110000001
100000000010000000000000000D100000011
1000000111000000000000000011100000001
1000100DD000000E00001000000000000001
10000001110000001001 1000000000000001
100000000000000000001000000000000001
100000000000000000000000000000000001
111111111111111111111111111111111111
11111111111							1
10000000011							1
11111111111
							1